XXXXX XXX
X       X
X XXXXXXX
X X X XXX
X X XXXXX
X       X
XXXXX XXX
